1111111111111111
1001000C000C0001
1000110110000001
1P0000000C000001
1000C00C00E01011
100C1000C1000001
1000C1000C001001
1111111111111111