1111111111111111
10010000000C0001
1000110110000001
1P0000E00C000001
1000000000001001
100C1000C1000001
1000C1000C001001
1111111111111111