1111111111111
10010000000C1
1000110110001
1P0011E00C001
1000001000001
100C1000C1001
1111111111111