1111111111111111111111111111111111
1E0000000000000C00000C000000000001
101001010010000E101001000000010101
10100100101010100010010000C0010101
1P0000000C00C000000000000000000011
1111111111111111111111111111111111